111111111111111
11E0CP000000001
111111111111111
