1111111111111
100100P0000C1
10E0011111001
1000110000001
1111111111111
