1111111111111111111111111111111111111111111
1000000000000000000000000000000000000000001
1000000010000000000000000000000000000000001
1000000000111111000000000000000000000000001
1000000010010010000000000000000000000000001
1000000010010010000000000000000000000000001
1000111011010011000100011100000000001110001
10010001000P0000000100000100011111010001001
1001111000000000011111000100000000010001001
1001000000000000000100000100011111010001001
1000111100000000000100011111000000001110001
10000000000000000000000000E0C00000000000001
1111111111111111111111111111111111111111111
