11111111111
10000000001
10010000001
1PP000100E1
1E000000001
11111111111
