1111111111111
10010000000C1
1000011111001
100011000000
100001P111001
1000010111001
10E0011111001
1000111110001
1111111111111
