1111111111111
1001000000CC1
1C00011111001
1P0011E0000E1
1111111111111
